一	いち	/(num) one/(P)/	ichi
一つ	ひとつ	/(n) one/(P)/	hitotsu
一人	ひとり	/(n) one person/(P)/	hitori
一日	いちにち	/(n) (1) first of month/(P)/	ichinichi
一日	ついたち	/(n) (1) first of month/(P)/	tsuitachi
一月	ひとつき	/one month/(P)/	hitotsuki
一緒	いっしょ	/(adv,n) together/meeting/company/(P)/	itsusho
七	しち	/(num) seven/(P)/	shichi
七つ	ななつ	/(n) seven/(P)/	nanatsu
七日	なのか	/(n-adv) seven days/the seventh day (of the month)/(P)/	nanoka
万	まん	/(adv,num) 10,000/ten thousand/myriads/all/everything/	man
万年筆	まんねんひつ	/(n) fountain pen/(P)/	mannenhitsu
丈夫	じょうぶ	/(adj-na,n) (1) hero/gentleman/warrior/manly person/(2) good health/robustness/strong/solid/durable/	jiyoubu
三	さん	/(num) three/(P)/	san
三つ	みっつ	/(n) three/(P)/	mittsu
三日	みっか	/(n) three days/the third day (of the month)/(P)/	mikka
上	うえ	/(gno-adj,gn-adv,gn,gn-suf) above/over/on top of/up/	ue
上げる	あげる	/(v1) to give/to raise/to elevate/to fly (kites)/to praise/to increase/to advance/to promote/to vomit/to usher in/to admit/to send (to school)/to offer/to present/to leave with/to finish/to arrange (expenses)/to observe/to perform/to quote/to mention/to bear (a child)/to improve (talents)/to do up (the hair)/to arrest/to engage/to fry/(rains) to stop/(P)/	ageru
上手	じょうず	/(adj-na,n) skill/skillful/dexterity/(P)/	jiyouzu
上着	うわぎ	/(n) coat/tunic/jacket/outer garment/(P)/	uwagi
下	した	/(n) under/below/beneath/(P)/	shita
下手	へた	/(adj-na,n) unskillful/poor/awkward/(P)/	heta
両親	りょうしん	/(n) parents/both parents/(P)/	ryoushin
並ぶ	ならぶ	/(v5b,vi) to line up/to stand in a line/(P)/	narabu
並べる	ならべる	/(v1,vt) to line up/to set up/(P)/	naraberu
中	なか	/(n) inside/middle/among/(P)/	naka
丸い	まるい	/(adj) round/circular/spherical/(P)/	marui
乗る	のる	/(v5r) (1) to get on/to ride in/to board/to mount/to get up on/to spread (paints)/to be taken in/(2) to share in/to join/to be found in (a dictionary)/to feel like doing/to be mentioned in/to be in harmony with/(P)/	noru
九	きゅう	/(num) nine/(P)/	kyuu
九つ	ここのつ	/(n) nine/(P)/	kokonotsu
九日	ここのか	/nine days/the ninth day (of the month)/(P)/	kokonoka
二	に	/(num) two/(P)/	ni
二つ	ふたつ	/(n) two/(P)/	futatsu
二人	ふたり	/(n) two persons/two people/pair/couple/(P)/	futari
二十日	はつか	/(n) twenty days/twentieth (day of the month)/(P)/	hatsuka
二十歳	はたち	/(n) 20 years old/20th year/(P)/	hatachi
二日	ふつか	/(n) second day of the month/two days/(P)/	futsuka
五	ご	/(num) five/(P)/	go
五つ	いつつ	/(n) five/(P)/	itsutsu
五日	いつか	/(n) five days/the fifth day (of the month)/(P)/	itsuka
交番	こうばん	/(n) police box/(P)/	kouban
人	ひと	/(n) man/person/human being/mankind/people/character/personality/true man/man of talent/adult/other people/messenger/visitor/(P)/	hito
今	いま	/this/now/	ima
今年	ことし	/(n-adv,n-t) this year/	kotoshi
今日	きょう	/(n-t) today/this day/(P)/	kyou
今晩	こんばん	/(n-adv,n-t) tonight/this evening/(P)/	konban
今月	こんげつ	/(n-adv,n-t) this month/(P)/	kongetsu
今朝	けさ	/(ik) (n-t) this morning/(P)/	kesa
今週	こんしゅう	/(n-adv,n-t) this week/(P)/	konshuu
仕事	しごと	/(adj-no,n) work/occupation/employment/(P)/	shigoto
休み	やすみ	/(n) (1) rest/recess/respite/(2) vacation/holiday/absence/suspension/(3) moulting/(P)/	yasumi
休む	やすむ	/(v5m,vi) to rest/to have a break/to take a day off/to be finished/to be absent/to retire/to sleep/(P)/	yasumu
会う	あう	/(v5u) to meet/to interview/(P)/	au
会社	かいしゃ	/(n) company/corporation/(P)/	kaisha
伯母	おば	/(n) (hum) aunt (older than one's parent)/	oba
伯父	おじ	/(n) (hum) uncle (older than one's parent)/	oji
低い	ひくい	/(adj) short/low/humble/low (voice)/(P)/	hikui
住む	すむ	/(v5m) to abide/to reside/to live in/to inhabit/to dwell/(P)/	sumu
体	からだ	/(n) (1) body/(2) health/	karada
何	なに	/(int,n) what/(P)/	nani
何	なん	/(int,n) what/(P)/	nan
作る	つくる	/(v5r) to make/to create/to manufacture/to draw up/to write/to compose/to build/to coin/to cultivate/to organize/to establish/to make up (a face)/to trim (a tree)/to fabricate/to prepare (food)/to commit (sin)/to construct/(P)/	tsukuru
作文	さくぶん	/(n) composition/writing/(P)/	sakubun
使う	つかう	/(v5u) to use/to handle/to manipulate/to employ/to need/to want/to spend/to consume/to speak (English)/to practise (fencing)/to take (one's lunch)/to circulate (bad money)/(P)/	tsukau
便利	べんり	/(adj-na,n) convenient/handy/useful/(P)/	benri
借りる	かりる	/(v1) to borrow/to have a loan/to hire/to rent/to buy on credit/(P)/	kariru
傘	かさ	/(n) umbrella/parasol/(P)/	kasa
働く	はたらく	/(v5k) to work/to labor/to do/to act/to commit/to practise/to work on/to come into play/to be conjugated/to reduce the price/(P)/	hataraku
元気	げんき	/(adj-na,n) health(y)/robust/vigor/energy/vitality/vim/stamina/spirit/courage/pep/(P)/	genki
兄	あに	/(n) (hum) older brother/(P)/	ani
兄弟	きょうだい	/(n) (hum) siblings/(P)/	kyoudai
先	さき	/(adj-no,n) the future/priority/precedence/former/previous/old/late/	saki
先月	せんげつ	/(n-adv,n-t) last month/(P)/	sengetsu
先生	せんせい	/(n) teacher/master/doctor/(P)/	sensei
先週	せんしゅう	/(n-adv,n-t) last week/the week before/(P)/	senshuu
入る	はいる	/(v5r) to enter/to break into/to join/to enroll/to contain/to hold/to accommodate/to have (an income of)/(P)/	hairu
入れる	いれる	/(v1) to put in/to take in/to bring in/	ireru
入口	いりぐち	/(n) entrance/gate/approach/mouth/	iriguchi
全部	ぜんぶ	/(n-adv,n-t) all/entire/whole/altogether/(P)/	zenbu
八	はち	/(num) eight/	hachi
八つ	やっつ	/(num) eight/	yattsu
八日	ようか	/(n) eight days/the eighth (day of the month)/(P)/	youka
八百屋	やおや	/(n) greengrocer/(P)/	yaoya
公園	こうえん	/(n) (public) park/(P)/	kouen
六	ろく	/(num) six/(P)/	roku
六つ	むっつ	/(num) six/	muttsu
六日	むいか	/six days/sixth (day of month)/(P)/	muika
円	えん	/(gn) (1) Yen, money/(2) circle/	en
円い	まるい	/(adj) round/circular/spherical/(P)/	marui
再来年	さらいねん	/(n-adv,n-t) year after next/(P)/	sarainen
写真	しゃしん	/(n) photograph/(P)/	shashin
冬	ふゆ	/(n-adv,n-t) winter/(P)/	fuyu
冷たい	つめたい	/(adj) cold (to the touch)/chilly/icy/freezing/coldhearted/(P)/	tsumetai
冷蔵庫	れいぞうこ	/(n) refrigerator/(P)/	reizouko
出かける	でかける	/(v1) to depart/to go out (e.g. on an excursion or outing)/to set out/to start/to be going out/	dekakeru
出す	だす	/(v5s) to put out/to send/(P)/	dasu
出る	でる	/(v1) to appear/to come forth/to leave/(P)/	deru
出口	でぐち	/(n) exit/gateway/way out/outlet/leak/vent/(P)/	deguchi
分る	わかる	/(io) (v5r) to be understood/	wakaru
切る	きる	/(suf,v5r) to cut/to chop/	kiru
切手	きって	/(n) stamp (eg. postage)/	kitte
切符	きっぷ	/(n) ticket/(P)/	kippu
初めて	はじめて	/(adv,n) for the first time/(P)/	hajimete
初めに	はじめに	/(expr) to begin with/first of all/	hajimeni
前	まえ	/(n-adv,n-t,suf) (1) before/in front/fore part/ago/previously/(2) head (of a line)/(3) in the presence of/lady (so-and-so)/(4) (five minutes) to/(5) helping/portion/(P)/	mae
勉強	べんきょう	/(n,vs) study/diligence/discount/reduction/(P)/	benkyou
動物	どうぶつ	/(n) animal/(P)/	doubutsu
勤める	つとめる	/(v1) (1) to serve/to fill a post/to serve under/to work (for)/(2) to exert oneself/to endeavor/to be diligent/(3) to play (the part of)/(P)/	tsutomeru
北	きた	/north/	kita
医者	いしゃ	/(n) doctor (medical)/(P)/	isha
十	じゅう	/(num) 10/ten/(P)/	jiyuu
十	とお	/(num) 10/ten/(P)/	too
十日	とおか	/ten days/the tenth (day of the month)/(P)/	tooka
千	せん	/thousand/many/(P)/	sen
午前	ごぜん	/(n-adv,n-t) morning/A.M./am/(P)/	gozen
午後	ごご	/(n-adv,n-t) afternoon/p.m./pm/(P)/	gogo
半	はん	/(n-adv,n,n-suf) half/(P)/	han
半分	はんぶん	/half minute/	hanbun
南	みなみ	/(n,vs) South/proceeding south/(P)/	minami
危ない	あぶない	/(adj) dangerous/critical/grave/uncertain/unreliable/limping/narrow/close/watch out!/(P)/	abunai
卵	たまご	/(n) (1) egg(s)/spawn/roe/(2) (an expert) in the making/(P)/	tamago
厚い	あつい	/(adj) cordial/kind/warm(hearted)/thick/deep/(P)/	atsui
去年	きょねん	/(n-adv,n-t) last year/	kyonen
友達	ともだち	/(n) friend/(P)/	tomodachi
叔母	おば	/(n) aunt (younger than one's parent)/(P)/	oba
叔父	おじ	/(n) uncle (younger than one's parent)/(P)/	oji
取る	とる	/(v5r) to take/to pick up/to harvest/to earn/to choose/(P)/	toru
口	くち	/(n) mouth/orifice/opening/(P)/	kuchi
古い	ふるい	/(adj) old (not person)/aged/ancient/antiquated/stale/threadbare/outmoded/obsolete article/(P)/	furui
台所	だいどころ	/(n) kitchen/(P)/	daidokoro
右	みぎ	/(n) right hand side/(P)/	migi
同じ	おなじ	/(adj-na,n) same/identical/equal/uniform/equivalent/similar/common (origin)/changeless/(P)/	onaji
名前	なまえ	/(n) name/(P)/	namae
向こう	むこう	/(n) beyond/over there/opposite direction/the other party/(P)/	mukou
吸う	すう	/(v5u) to smoke/to breathe in/to suck/(P)/	suu
吹く	ふく	/(v5k) (1) to blow (wind, etc)/(2) to emit/to spout/(P)/	fuku
呼ぶ	よぶ	/(v5b) to call out/to invite/(P)/	yobu
咲く	さく	/(v5k) to bloom/(P)/	saku
問題	もんだい	/(n) problem/question/(P)/	mondai
喫茶店	きっさてん	/(n) coffee lounge/(P)/	kitsusaten
四	し	/(num) four/(P)/	shi
四つ	よっつ	/(n) four/(P)/	yottsu
四日	よっか	/(n) (1) 4th day of month/(2) four days/(P)/	yokka
困る	こまる	/(v5r) to be worried/to be bothered/(P)/	komaru
図書館	としょかん	/(n) library/(P)/	toshokan
国	くに	/(n) country/(P)/	kuni
土曜日	どようび	/(n-adv,n) Saturday/(P)/	doyoubi
地下鉄	ちかてつ	/(n) underground train/subway/(P)/	chikatetsu
地図	ちず	/(n) map/(P)/	chizu
塩	しお	/(n) salt/(P)/	shio
声	こえ	/(n) voice/(P)/	koe
売る	うる	/(v5r) to sell/(P)/	uru
夏	なつ	/(n-adv,n-t) summer/(P)/	natsu
夏休み	なつやすみ	/(n) summer vacation/summer holiday/(P)/	natsuyasumi
夕方	ゆうがた	/(n-adv,n-t) evening/(P)/	yuugata
外	そと	/(n) outside, exterior/(P)/	soto
外	ほか	/(n) other place/the rest/(P)/	hoka
外国	がいこく	/(n) foreign country/(P)/	gaikoku
外国人	がいこくじん	/(n) foreigner/(P)/	gaikokujin
夜	よる	/(n-adv,n-t) evening/night/(P)/	yoru
大きい	おおきい	/(adj) big/large/great/(P)/	ookii
大丈夫	だいじょうぶ	/(adj-na,adv,n) safe/all right/O.K./(P)/	daijiyoubu
大人	おとな	/(n) adult/	otona
大使館	たいしかん	/(n) embassy/(P)/	taishikan
大切	たいせつ	/(adj-na,n) important/(P)/	taisetsu
大勢	おおぜい	/(n) great number of people/	oozei
大好き	だいすき	/(adj-na,n) very likeable/like very much/(P)/	daisuki
大学	だいがく	/(n) university/(P)/	daigaku
天気	てんき	/(n) weather/the elements/fine weather/(P)/	tenki
太い	ふとい	/(adj) fat/thick/(P)/	futoi
奥さん	おくさん	/(n) (hon) wife/your wife/his wife/married lady/madam/(P)/	okusan
女	おんな	/(n) woman/girl/daughter/	onna
女の子	おんなのこ	/(n) girl/(P)/	onnanoko
好き	すき	/(adj-na,n) liking/fondness/love/(P)/	suki
妹	いもうと	/(n) (hum) younger sister/(P)/	imouto
姉	あね	/(n) (hum) older sister/(P)/	ane
始まる	はじまる	/(v5r,vi) to begin/(P)/	hajimaru
嫌	いや	/(adj-na,n) disagreeable/detestable/unpleasant/reluctant/(P)/	iya
嫌い	きらい	/(adj-na,n) dislike/hate/(P)/	kirai
子供	こども	/(n) child/children/(P)/	kodomo
字引	じびき	/(n) dictionary/(P)/	jibiki
学校	がっこう	/(n) school/(P)/	gakkou
学生	がくせい	/(n) student/(P)/	gakusei
安い	やすい	/(adj) cheap/inexpensive/peaceful/quiet/gossipy/thoughtless/(P)/	yasui
家	いえ	/(suf) house/family/(P)/	ie
家内	かない	/(n) (hum) wife/(P)/	kanai
家族	かぞく	/(n) family/members of a family/(P)/	kazoku
宿題	しゅくだい	/(n) homework/(P)/	shukudai
寒い	さむい	/(adj) cold (e.g. weather)/(P)/	samui
寝る	ねる	/(v1) to go to bed/to lie down/to sleep/(P)/	neru
封筒	ふうとう	/(n) envelope/(P)/	fuutou
小さい	ちいさい	/(adj) small/little/tiny/(P)/	chiisai
少し	すこし	/(adv,n) (1) small quantity/little/few/something/(2) little while/(3) short distance/(P)/	sukoshi
居る	いる	/(v5r) (uk) (hum) to be (animate)/to be/to exist/(P)/	iru
山	やま	/(n) (1) mountain/(2) pile/heap/(3) climax/critical point/(P)/	yama
川	かわ	/(n) river/(P)/	kawa
工	く		ku
左	ひだり	/(n) left hand side/(P)/	hidari
帰る	かえる	/(v5r) to go back/to go home/to come home/to return/(P)/	kaeru
帽子	ぼうし	/(n) hat/(P)/	boushi
平仮名	ひらがな	/(n) hiragana/47 syllables/the cursive syllabary/(P)/	hiragana
広い	ひろい	/(adj) spacious/vast/wide/(P)/	hiroi
店	みせ	/(n,n-suf) store/shop/establishment/(P)/	mise
座る	すわる	/(v5r) to sit/(P)/	suwaru
庭	にわ	/(n) garden/(P)/	niwa
建物	たてもの	/(n) building/(P)/	tatemono
引く	ひく	/(v5k) minus/to pull/to play (string instr.)/(P)/	hiku
弟	おとうと	/(n) younger brother/faithful service to those older/brotherly affection/	otouto
強い	つよい	/(adj) strong/powerful/mighty/potent/(P)/	tsuyoi
弾く	ひく	/(v5k) to play (piano, guitar)/(P)/	hiku
待つ	まつ	/(v5t) to wait/(P)/	matsu
後	あと	/(adj-no,n) afterwards/since then/in the future/(P)/	ato
後	うしろ	/(gn) back/behind/rear/	ushiro
御主人	ごしゅじん	/(n) (hon) your husband/her husband/	goshujin
御飯	ごはん	/(n) rice (cooked)/meal/(P)/	gohan
忘れる	わすれる	/(v1) to forget/to leave carelessly/to be forgetful of/to forget about/to forget (an article)/(P)/	wasureru
忙しい	いそがしい	/(adj) busy/irritated/	isogashii
悪い	わるい	/(adj) bad/inferior/(P)/	warui
意味	いみ	/(n,vs) meaning/significance/(P)/	imi
戸	と	/(n) door (Japanese style)/(P)/	to
所	ところ	/(n) place/(P)/	tokoro
手	て	/(n) hand/(P)/	te
手紙	てがみ	/(n) letter/(P)/	tegami
押す	おす	/(v5s,vt) to push/to press/to stamp (i.e. a passport)/(P)/	osu
持つ	もつ	/(v5t) (1) to hold/to carry/(2) to possess/(P)/	motsu
掃除	そうじ	/(n,vs) cleaning/sweeping/(P)/	souji
授業	じゅぎょう	/(n,vs) lesson/class work/(P)/	jiyugyou
撮る	とる	/(v5r) to take (a photo)/to make (a film)/(P)/	toru
教える	おしえる	/(v1) to teach/to inform/to instruct/(P)/	oshieru
教室	きょうしつ	/(n) classroom/(P)/	kyoushitsu
散歩	さんぽ	/(n,vs) walk/stroll/(P)/	sanpo
料理	りょうり	/(n,vs) cooking/cookery/cuisine/(P)/	ryouri
新しい	あたらしい	/(adj) new/(P)/	atarashii
新聞	しんぶん	/(n) newspaper/(P)/	shinbun
旅行	りょこう	/(n,vs) travel/trip/(P)/	ryokou
日曜日	にちようび	/(n-adv,n) Sunday/(P)/	nichiyoubi
早い	はやい	/(adj) early/(P)/	hayai
明い	あかるい	/(adj) bright/cheerful/	akarui
易しい	やさしい	/(adj) easy/plain/simple/(P)/	yasashii
映画	えいが	/(n) movie/film/(P)/	eiga
映画館	えいがかん	/(n) movie theatre (theater)/cinema/(P)/	eigakan
春	はる	/(n-adv,n-t) spring/(P)/	haru
昨日	きのう	/(n-adv,n-t) yesterday/(P)/	kinou
昼	ひる	/(n-adv,n-t) noon/daytime/(P)/	hiru
昼御飯	ひるごはん	/(n) lunch/midday meal/	hirugohan
時々	ときどき	/(adv,n) sometimes/(P)/	tokidoki
時計	とけい	/(n) watch/clock/(P)/	tokei
時間	じかん	/(n-adv,n) time/(P)/	jikan
晩	ばん	/(n-adv,n-t) evening/(P)/	ban
晩御飯	ばんごはん	/(n) dinner/evening meal/	bangohan
晴れる	はれる	/(v1) to be sunny/to clear away/to stop raining/(P)/	hareru
暇	ひま	/(adj-na,n) (1) free time/leisure/leave/spare time/(2) farewell/	hima
暑い	あつい	/(adj) hot/warm/(P)/	atsui
暖かい	あたたかい	/(adj) warm/mild/genial/(P)/	atatakai
暗い	くらい	/(adj) (uk) dark/gloomy/(P)/	kurai
曇る	くもる	/(v5r) to become cloudy/to become dim/(P)/	kumoru
曲る	まがる	/(uv) to turn/to bend/	magaru
書く	かく	/(v5k) to write/(P)/	kaku
月曜日	げつようび	/(n-adv,n) Monday/(P)/	getsuyoubi
有名	ゆうめい	/(adj-na,n) fame/(P)/	yuumei
服	ふく	/(n,n-suf) clothes/(P)/	fuku
朝	あさ	/(n-adv,n-t) morning/(P)/	asa
朝御飯	あさごはん	/(n) breakfast/(P)/	asagohan
木	き	/(n) tree/wood/timber/(P)/	ki
木曜日	もくようび	/(n-adv,n) Thursday/(P)/	mokuyoubi
本	ほん	/(n) book/	hon
本棚	ほんだな	/(n) bookshelves/(P)/	hondana
机	つくえ	/(n) desk/(P)/	tsukue
来る	くる	/(vk) to come/	kuru
来年	らいねん	/(n-adv,n-t) next year/(P)/	rainen
来月	らいげつ	/(n-adv,n-t) next month/(P)/	raigetsu
来週	らいしゅう	/(n-adv,n-t) next week/(P)/	raishuu
東	ひがし	/(n) east/(P)/	higashi
果物	くだもの	/(n) fruit/(P)/	kudamono
楽しい	たのしい	/(adj) enjoyable/fun/(P)/	tanoshii
横	よこ	/(n) beside/side/width/(P)/	yoko
橋	はし	/(n) bridge/(P)/	hashi
次	つぎ	/(n) next/stage station/stage/subsequent/(P)/	tsugi
欲しい	ほしい	/(adj) wanted/wished for/in need of/desired/(P)/	hoshii
歌	うた	/(n) song/poetry/(P)/	uta
歌う	うたう	/(v5u) to sing/(P)/	utau
止まる	とまる	/(v5r) to come to a halt/(P)/	tomaru
歩く	あるく	/(v5k) to walk/(P)/	aruku
歯	は	/(n) tooth/(P)/	ha
死ぬ	しぬ	/(v5n) to die/(P)/	shinu
母	はは	/(n) (hum) mother/(P)/	haha
毎年	まいとし	/(n-t) every year/yearly/annually/(P)/	maitoshi
毎年	まいねん	/(n-t) every year/yearly/annually/(P)/	mainen
毎日	まいにち	/(n-adv,n-t) every day/(P)/	mainichi
毎晩	まいばん	/(n-adv,n-t) every night/(P)/	maiban
毎月	まいげつ	/(n-adv,n) every month/each month/monthly/(P)/	maigetsu
毎月	まいつき	/(n-adv,n) every month/each month/monthly/(P)/	maitsuki
毎朝	まいあさ	/(n-adv,n-t) every morning/	maiasa
毎週	まいしゅう	/(n-adv,n-t) every week/(P)/	maishuu
水	みず	/(n) water/(P)/	mizu
水曜日	すいようび	/(n-adv,n) Wednesday/(P)/	suiyoubi
汚い	きたない	/(adj) dirty/unclean/filthy/(P)/	kitanai
池	いけ	/(n) pond/(P)/	ike
河	かわ	/(n) river/stream/(P)/	kawa
泳ぐ	およぐ	/(v5g) to swim/(P)/	oyogu
洋服	ようふく	/(n) Western-style clothes/(P)/	youfuku
洗う	あらう	/(v5u) to wash/(P)/	arau
洗濯	せんたく	/(n,vs) washing/laundry/(P)/	sentaku
海	うみ	/(n) sea/beach/(P)/	umi
消える	きえる	/(v1) to go out/to vanish/to disappear/(P)/	kieru
消す	けす	/(v5s) to erase/to delete/to turn off power/(P)/	kesu
涼しい	すずしい	/(adj) cool/refreshing/(P)/	suzushii
渡す	わたす	/(v5s) to pass over/to hand over/(P)/	watasu
渡る	わたる	/(v5r) to cross over/to go across/(P)/	wataru
漢字	かんじ	/(n) Chinese characters/kanji/(P)/	kanji
火曜日	かようび	/(n-adv,n) Tuesday/(P)/	kayoubi
灰皿	はいざら	/(n) ashtray/(P)/	haizara
熱い	あつい	/(adj) hot (thing)/(P)/	atsui
父	ちち	/(n) (hum) father/(P)/	chichi
片仮名	かたかな	/(n) katakana/(P)/	katakana
牛肉	ぎゅうにく	/(n) beef/(P)/	gyuuniku
物	もの	/(n) thing/object/(P)/	mono
狭い	せまい	/(adj) narrow/confined/small/(P)/	semai
玄関	げんかん	/(n) entranceway/entry hall/(P)/	genkan
甘い	あまい	/(gadj) generous/easy-going/sweet／	amai
生まれる	うまれる	/(v1) to be born/(P)/	umareru
生徒	せいと	/(n) pupil/(P)/	seito
男	おとこ	/(n) man/(P)/	otoko
男の子	おとこのこ	/(n) boy/(P)/	otokonoko
町	まち	/(n) (1) town/(2) street/road/(P)/	machi
留学生	りゅうがくせい	/(n) overseas student/(P)/	ryuugakusei
番号	ばんごう	/(n) number/series of digits/(P)/	bangou
疲れる	つかれる	/(v1) to get tired/to tire/(P)/	tsukareru
病気	びょうき	/(n) illness/disease/sickness/(P)/	byouki
病院	びょういん	/(n) hospital/(P)/	byouin
痛い	いたい	/(adj) painful/(P)/	itai
登る	のぼる	/(v5r) to climb/(P)/	noboru
白い	しろい	/(adj) white/(P)/	shiroi
百	ひゃく	/(num) 100/hundred/(P)/	hyaku
皆さん	みなさん	/(n) everyone/(P)/	minasan
目	め	/(n) eye/eyeball/(P)/	me
眼鏡	めがね	/(n) spectacles/glasses/(P)/	megane
着く	つく	/(v5k) to arrive at/to reach/(P)/	tsuku
着る	きる	/(v1) to wear/to put on (from shoulders down)/(P)/	kiru
知る	しる	/(v5r) to know/to understand/to be acquainted with/to feel/(P)/	shiru
短い	みじかい	/(adj) short/(P)/	mijikai
砂糖	さとう	/(n) sugar/(P)/	satou
磨く	みがく	/(v5k) to polish/to shine/to brush/to refine/to improve/(P)/	migaku
私	わたし/わたくし	/(adj-no,n) I/myself/private affairs/(P)/	watashi/watakushi
秋	あき	/(n-adv) autumn/fall/(P)/	aki
空	そら	/(n) sky/(P)/	sora
窓	まど	/(n) window/(P)/	mado
立つ	たつ	/(v5t) to stand/(P)/	tatsu
答える	こたえる	/(v1) to answer/to reply/	kotaeru
箱	はこ	/(n) box/(P)/	hako
紙	かみ	/(n) paper/(P)/	kami
細い	ほそい	/(adj) thin/slender/fine/(P)/	hosoi
終る	おわる	/(io) (v5r) to finish/to close/	owaru
結婚	けっこん	/(adj-no,n,vs) marriage/(P)/	kekkon
結構	けっこう	/(adj-na,n-adv,n) (1) (uk) splendid/nice/wonderful/delicious/sweet/(2) (arch) construction/architecture/(3) well enough/tolerably/(P)/	kekkou
絵	え	/(n,n-suf) picture/drawing/painting/sketch/	e
締める	しめる	/(v1) to tie/to fasten/(P)/	shimeru
練習	れんしゅう	/(n,vs) practice/(P)/	renshuu
置く	おく	/(v5k) to put/to place/(P)/	oku
習う	ならう	/(v5u) to learn/(P)/	narau
耳	みみ	/(n) ear/(P)/	mimi
聞く	きく	/(v5k) to hear/to listen/to ask/(P)/	kiku
肉	にく	/(n) meat/(P)/	niku
背	せい	/(n) height/stature/(P)/	sei
背広	せびろ	/(n) business suit/(P)/	sebiro
脱ぐ	ぬぐ	/(v5g) to take off clothes/(P)/	nugu
自分	じぶん	/(n) myself/oneself/(P)/	jibun
自動車	じどうしゃ	/(n) automobile/(P)/	jidousha
自転車	じてんしゃ	/(n) bicycle/(P)/	jitensha
色	いろ	/(n) (1) colour/(2) sensuality/lust/(P)/	iro
花	はな	/(n) flower/(P)/	hana
花瓶	かびん	/(n) (flower) vase/(P)/	kabin
若い	わかい	/(adj) young/(P)/	wakai
英語	えいご	/(n) the English language/(P)/	eigo
茶色	ちゃいろ	/(n) light brown/tawny/(P)/	chairo
荷物	にもつ	/(n) luggage/(P)/	nimotsu
葉書	はがき	/(n) postcard/(P)/	hagaki
薄い	うすい	/(adj) thin/weak/watery/diluted/(P)/	usui
薬	くすり	/(n) medicine/(P)/	kusuri
行く	いく	/(v5k-s) to go/(P)/	iku
行く	ゆく	/(v5k-s) to go/(P)/	yuku
西	にし	/(n) west/(P)/	nishi
要る	いる	/(v5r) to need/(P)/	iru
見せる	みせる	/(v1) to show/to display/(P)/	miseru
見る	みる	/(v1) to see/to watch/(P)/	miru
覚える	おぼえる	/(v1) to remember/to memorize/(P)/	oboeru
角	かど	/(n) corner (e.g. desk, pavement)/	kado
言う	いう	/(v5u) to say/(P)/	iu
言葉	ことば	/(n) word(s)/language/speech/(P)/	kotoba
話	はなし	/(io) (n) talk/speech/chat/story/conversation/(P)/	hanashi
話す	はなす	/(v5s) to speak/(P)/	hanasu
誕生日	たんじょうび	/(n) birthday/(P)/	tanjiyoubi
読む	よむ	/(v5m) to read/(P)/	yomu
豚肉	ぶたにく	/(n) pork/(P)/	butaniku
買い物	かいもの	/(n) shopping/(P)/	kaimono
買う	かう	/(v5u) to buy/(P)/	kau
貸す	かす	/(v5s) to lend/(P)/	kasu
質問	しつもん	/(n,vs) question/inquiry/(P)/	shitsumon
赤い	あかい	/(adj) red/(P)/	akai
走る	はしる	/(v5r) to run/(P)/	hashiru
起きる	おきる	/(v1) to get up/to rise/(P)/	okiru
足	あし	/(n) foot/pace/gait/leg/(P)/	ashi
車	くるま	/(n) car/vehicle/wheel/(P)/	kuruma
軽い	かるい	/(adj) light/non-serious/minor/(P)/	karui
辛い	からい	/hot (spicy)/salty/	karai
辞書	じしょ	/(n) dictionary/lexicon/(P)/	jisho
辺	へん	/(n) area/vicinity/(P)/	hen
近い	ちかい	/(adj,suf) near/close by/short/(P)/	chikai
近く	ちかく	/(n-adv,n) near/neighbourhood/vicinity/(P)/	chikaku
返す	かえす	/(v5s,vt) to return something/(P)/	kaesu
速い	はやい	/(adj) quick/fast/swift/(P)/	hayai
遅い	おそい	/(adj) late/slow/(P)/	osoi
遊ぶ	あそぶ	/(v5b) (1) to play/to make a visit (esp. for pleasure)/(2) to be idle/to do nothing/(P)/	asobu
道	みち	/(n) road/street/way/method/(P)/	michi
違う	ちがう	/(v5u) to differ (from)/(P)/	chigau
遠い	とおい	/(adj) far/distant/(P)/	tooi
部屋	へや	/(n) room/(P)/	heya
郵便局	ゆうびんきょく	/(n) post office/(P)/	yuubinkyoku
重い	おもい	/(adj) (1) heavy/massive/(2) serious/important/severe/oppressed/(P)/	omoi
野菜	やさい	/(n) vegetable/(P)/	yasai
金曜日	きんようび	/(n-adv,n) Friday/(P)/	kinyoubi
鉛筆	えんぴつ	/(n) pencil/(P)/	enpitsu
銀行	ぎんこう	/(n) bank/(P)/	ginkou
長い	ながい	/(adj) long/(P)/	nagai
門	もん	/(n,n-suf) gate/(P)/	mon
閉まる	しまる	/(v5r,vi) to close/to be closed/(P)/	shimaru
閉める	しめる	/(v1,vt) to close/to shut/(P)/	shimeru
開く	あく	/(v5k) to open (e.g. a festival)/(P)/	aku
開ける	あける	/(v1) to become civilized/to become opened up/be up-to-date/(P)/	akeru
降りる	おりる	/(v1) to alight (e.g. from bus)/to get off/to descend (e.g. a mountain)/(P)/	oriru
降る	ふる	/(v5r) to precipitate/to fall (e.g. rain)/(P)/	furu
階段	かいだん	/(n) stairs/(P)/	kaidan
隣	となり	/(n) next to/next door to/(P)/	tonari
雑誌	ざっし	/(n) journal/magazine/(P)/	zatsushi
難しい	むずかしい	/(adj) difficult/(P)/	muzukashii
雨	あめ	/(n) rain/(P)/	ame
雪	ゆき	/(n) snow/(P)/	yuki
零	れい	/(n) zero/nought/(P)/	rei
電気	でんき	/(n) electricity/(electric) light/(P)/	denki
電話	でんわ	/(n,vs) telephone/(P)/	denwa
電車	でんしゃ	/(n) electric train/(P)/	densha
青い	あおい	/(adj) blue/pale/green/unripe/inexperienced/(P)/	aoi
静か	しずか	/(adj-na) quiet/peaceful/(P)/	shizuka
靴	くつ	/(n) shoes/footwear/(P)/	kutsu
靴下	くつした	/(n) socks/(P)/	kutsushita
音楽	おんがく	/(n) music/musical movement/(P)/	ongaku
頭	あたま	/(n)head/	atama
頼む	たのむ	/(v5m) to request/to beg/to ask/(P)/	tanomu
顔	かお	/(n) face (person)/(P)/	kao
風	かぜ	/(n) wind/breeze/	kaze
飛ぶ	とぶ	/(v5b) to jump/to fly/to leap/to spring/to bound/to hop/(P)/	tobu
飛行機	ひこうき	/(n) aeroplane/(P)/	hikouki
食べる	たべる	/(v1) to eat/(P)/	taberu
食べ物	たべもの	/(n) food/(P)/	tabemono
食堂	しょくどう	/(n) cafeteria/dining hall/(P)/	shokudou
飲み物	のみもの	/(n) drink/beverage/(P)/	nomimono
飲む	のむ	/(v5m) to drink/(P)/	nomu
駅	えき	/(n) station/(P)/	eki
高い	たかい	/(adj) tall/high/expensive/(P)/	takai
魚	さかな	/(n) fish/(P)/	sakana
鳥	とり	/(n) bird/fowl/poultry/(P)/	tori
鳥肉	とりにく	/(n) chicken meat/	toriniku
鳴く	なく	/(v5k) to bark/to purr/to make sound (animal)/(P)/	naku
黄色い	きいろい	/(adj) yellow/(P)/	kiiroi
黒い	くろい	/(adj) (1) black/(2) dark/(P)/	kuroi
鼻	はな	/(n) nose/(P)/	hana
